################
#...........#..#
#...........#..#
#...........#..#
#...........#..#
#..............#
#..............#
#..............#
#..............#
#..............#
#..............#
#..............#
#..............#
#..............#
#..............#
################