################
#...........#..#
#...........#..#
#...........#..#
#...........#..#
#..............#
#..............#
#..............#
#..............#
#..............#
#.........#....#
#..............#
#..#...........#
#..#...........#
#..#...........#
################